Algeria	Algeria
Angola	Angola
Benin	Benin
Botswana	Botswana
Burkina_Faso	Burkina Faso
Burundi	Burundi
Cape_Verde	Cape Verde
Cameroon	Cameroon
Central_African_Republic	Central Af. Republic
Chad	Chad
Comoros	Comoros
Congo	Congo
Cote_dIvoire	Cote d'Ivoire
Democratic_Republic_of_the_Congo	Dem. Rep. Congo
Equatorial_Guinea	Equatorial Guinea
Eritrea	Eritrea
Ethiopia	Ethiopia
Gabon	Gabon
Gambia	Gambia
Ghana	Ghana
Guinea	Guinea
Guinea_Bissau	Guinea Bissau
Kenya	Kenya
Lesotho	Lesotho
Liberia	Liberia
Madagascar	Madagascar
Malawi	Malawi
Mali	Mali
Mauritania	Mauritania
Mozambique	Mozambique
Namibia	Namibia
Niger	Niger
Nigeria	Nigeria
Rwanda	Rwanda
Sao_Tome_and_Principe	Sao Tome and Principe
Senegal	Senegal
Sierra_Leone	Sierra Leone
South_Africa	South Africa
South_Sudan	South_Sudan
Eswatini	Eswatini
United_Republic_of_Tanzania	Unit. Rep. Tanzania
Togo	Togo
Uganda	Uganda
Zambia	Zambia
Zimbabwe	Zimbabwe
Mauritius	Mauritius
Seychelles	Seychelles